190,190,190,190,190,190,190,190,190,190,190,190,190
190,182,182,182,182,182,182,182,182,182,182,182,190
190,182,182,182,182,182,182,182,182,182,182,182,190
190,180,177,177,177,177,177,177,177,177,177,181,190
190,178,176,176,176,176,176,176,176,176,176,179,190
190,178,176,176,176,176,176,176,176,176,176,179,190
190,178,176,176,176,176,176,176,176,176,176,179,190
190,190,190,190,190,190,190,190,190,190,190,190,190
