-1,194,185,185,185,185,185,185,185,185,185,193,-1
-1,186,178,178,178,178,178,178,178,178,178,188,-1
-1,186,178,178,178,178,178,178,178,178,178,188,-1
-1,186,177,177,177,177,177,177,177,177,177,188,-1
-1,186,176,176,176,176,176,176,176,176,176,188,-1
-1,186,176,176,176,176,176,176,176,176,176,188,-1
-1,186,176,176,176,176,176,176,176,176,176,188,-1
-1,195,187,187,187,187,187,187,187,187,187,196,-1
