190,190,190,190,190,190,190,190,190,190,190,190,190
190,190,190,190,190,190,190,190,190,190,190,190,190
190,190,190,190,190,185,186,190,190,190,190,190,190
190,190,167,168,175,183,184,187,188,190,190,190,190
190,190,169,170,190,190,190,190,190,190,190,190,190
190,190,171,172,190,190,190,190,190,190,190,190,190
190,190,173,174,190,190,190,190,190,190,190,190,190
190,190,190,190,190,190,190,190,190,190,190,190,190
