5,5,5,5,5,5,5,5,5,5,5,5,5,5,5,5,5,5,5,5,5,5,5
5,40,24,24,32,32,32,40,40,32,24,40,32,32,7,7,7,32,32,5
5,40,24,24,24,40,40,24,40,32,40,32,40,24,15,7,7,32,40,5
5,32,24,32,24,40,40,32,32,32,40,40,24,32,7,7,55,24,40,5
5,40,40,40,32,40,24,40,24,32,40,32,40,24,7,7,71,24,32,5
5,24,32,32,32,24,32,24,40,40,40,32,32,32,7,7,7,40,32,5
5,32,24,32,24,40,24,24,32,24,40,24,32,24,7,55,15,24,32,5
5,32,24,40,24,40,32,40,24,24,32,24,40,32,7,7,7,24,24,40,5
5,5,5,5,5,5,5,5,5,5,5,5,5,5,5,5,5,5,5,5,5,5,5